5 5
1 1 1 1 1
1 * 1 * 1
1 * S * 1
1 * * * 1
1 1 1 T *
2 2
4 3